"filename", "language", "Markdown", "JSON", "Moonbit", "BNF", "comment", "blank", "total"
"/home/blankheart0/Interpreter/MBCI/MiniC.ebnf", "BNF", 0, 0, 0, 8, 4, 4, 16
"/home/blankheart0/Interpreter/MBCI/README.md", "Markdown", 1, 0, 0, 0, 0, 0, 1
"/home/blankheart0/Interpreter/MBCI/main/AST.mbt", "Moonbit", 0, 0, 10, 0, 3, 3, 16
"/home/blankheart0/Interpreter/MBCI/main/Debug.mbt", "Moonbit", 0, 0, 4, 0, 0, 1, 5
"/home/blankheart0/Interpreter/MBCI/main/ErrorHandler.mbt", "Moonbit", 0, 0, 28, 0, 0, 5, 33
"/home/blankheart0/Interpreter/MBCI/main/Excuter.mbt", "Moonbit", 0, 0, 86, 0, 3, 30, 119
"/home/blankheart0/Interpreter/MBCI/main/Interpreter.mbt", "Moonbit", 0, 0, 27, 0, 3, 4, 34
"/home/blankheart0/Interpreter/MBCI/main/Parser.mbt", "Moonbit", 0, 0, 127, 0, 6, 46, 179
"/home/blankheart0/Interpreter/MBCI/main/Scanner.mbt", "Moonbit", 0, 0, 122, 0, 9, 31, 162
"/home/blankheart0/Interpreter/MBCI/main/Token.mbt", "Moonbit", 0, 0, 98, 0, 10, 14, 122
"/home/blankheart0/Interpreter/MBCI/main/moon.pkg.json", "JSON", 0, 6, 0, 0, 0, 0, 6
"/home/blankheart0/Interpreter/MBCI/moon.mod.json", "JSON", 0, 9, 0, 0, 0, 0, 9
"/home/blankheart0/Interpreter/MBCI/test/expression.mbt", "Moonbit", 0, 0, 10, 0, 0, 2, 12
"/home/blankheart0/Interpreter/MBCI/test/moon.pkg.json", "JSON", 0, 1, 0, 0, 0, 0, 1
"/home/blankheart0/Interpreter/MBCI/test/scanner.mbt", "Moonbit", 0, 0, 25, 0, 0, 0, 25
"/home/blankheart0/Interpreter/MBCI/test/test.mbt", "Moonbit", 0, 0, 0, 0, 5, 1, 6
"Total", "-", 1, 16, 537, 8, 43, 141, 746